11111111111
10000000101
11211210101
10000010201
10201120101
10101000201
10121011101
10100020001
10102110101
10000000201
11111111111