1111111111111111
1020000000000001
1010121010121211
1000100010000001
1011101111110101
1010001000010201
1012110121012101
1000100001010001
1010121210010101
1201012101010101
1001010101010101
1120101010010101
1000101010100101
1012122101212111
1000000010100001
1111111111111111